verdi	Verdi
partecipazione	participation
roberto fiore	Roberto fiore
nichi vendola	Nichi vendola
alto rappresentante per la politica estera e di sicurezza comune	High Representative for the common foreign and security policy
tetto al tre percento	roof at three percent
impresario	impresario
politica agricola	agricultural policy
libertari di sinistra	left-libertarians
cassa integrazione	layoffs
fondo sociale europeo	European Social Fund
redistribuire	redistribute
politica estera e di sicurezza comune	common foreign and security policy
migranti irregolari	irregular migrants
sicurezza e giustizia	Security and justice
attac italia	ATTAC Italy
fiscal compact	fiscal compact
rajoy	Rajoy
sicurezza online	online security
storace	Storace
lista tsipras	list tsipras
campagna	campaign
carabinieri	Carabinieri
carabiniere	policeman
authority	authority
imposta	sets
sit in	sit in
john fredrik reinfeldt	John fredrik reinfeldt
immigrati irregolari	irregular migrants
extracomunitaria	extra-Community
imprenditrice	Entrepreneur
sitin	sitin
reddito minimo	minimum income
imprenditrici	entrepreneurs
eserciti militari	military armies
salari	wages
imposte	taxes
italia nostra	Italia nostra
comunitario	Community
garante	sponsor
farage	Farage
renzi	Renzi
jean-marie le pen	Jean-marie le pen
nativi digitali	digital natives
allevatore	breeder
infrazioni	infractions
anonymous italia	anonymous Italy
infrazione	infringement
troika	Troika
presidente del consiglio	Chairman of the Board
ncd	NCD
europea	European
scioperi	strikes
sindacati confederali	unions
sciopero	strike
farmaco	medication
farmaci	drugs
comizi	rallies
südtiroler volkspartei	South Tyrolean people's Party
precari	precarious
ep14	ep14
ucraina	Ukraine
presidente della commissione europea	President of the European Commission
costo della vita	cost of living
carta dei diritti	Bill of rights
carcere	prison
giudiziario	judicial officer
herman van rompuy	Herman van rompuy
agricoltrici	women farmers
carceri	prisons
agricoltrice	farmer
stipendiati	salaried
giudiziarie	judicial proceedings
françois hollande	François hollande
denominazione di origine protetta	protected designation of origin
giudiziaria	judicial
stipendiato	salaried
multiculturalismo	multiculturalism
privacy online	online privacy
reinfeldt	Reinfeldt
ecofin	Ecofin
nativo digitale	Digital native
fiducia istituzionale	institutional trust
politica di informazione e comunicazione	information and communication policy
monopolio	monopoly
native digitali	Digital native
stipendiata	salaried
stipendiate	salaried
professoressa	Professor
professoresse	female professors
conferenze stampa	press conferences
parlamentare europeo	Member of the European Parliament
lobby	lobby
allevatrice	breeder
cub	Cub
nigel farage	Nigel farage
energia	energy
processi	processes
eu14	eu14
processo	process
inquinamento	pollution
privacy	Privacy
anziane	older folks
anziana	old woman
fiducia nelle istituzioni	trust in institutions
movimento operaio	labor movement
david william donald cameron	David william donald cameron
agricoltori	farmers
autorità amministrativa indipendente	independent administrative authorities
agricoltore	farmer
allevatrici	breeders
bilanci	financial statements
liberali	Liberals
fondi europei	European funds
proteste	protests
ministro	Minister
protesta	protest
bankitalia	Bank of Italy
giuseppe grillo	Joseph grillo
anziani	seniors
m5s	M5S
ministre	Ministre
schultz	Schultz
ministri	Ministers
anziano	Elder
immigrata irregolare	irregular immigrant
geert wilders	Geert wilders
dazio doganale	customs duty
casapound italia	casapound Italy
ministra	Minister
allevatori	breeders
migrante	migrant
polizia	Police
bce	ECB
migranti	migrants
bernd lucke	Bernd lucke
europeo	European
eu2014	eu2014
casapound	casapound
europei	Europeans
forza italia	Forza italia
politiche sociali	social policies
europee	Europe
europa	Europe
digital divide	digital divide
corruzione	corruption
cobas	cobas
euroscettiche	Euro-sceptic
cameron	Cameron
libera	free
la lega	the League
tetto del tre percento	roof of three percent
alleanza libera europea	European Free Alliance
economia verde	green economy
indagine	investigation
diritto comunitario	Community law
indagini	investigations
astensionismo	turnout
ignazio visco	Ignazio visco
moneta unica	single currency
femminicidio	femicide
extracomunitario	outside the European Union
mister b	Mister b
senatori	Senators
volontario	volunteer
euromayday	EuroMayday
senatore	Senator
giorgio napolitano	Giorgio napolitano
libertà e giustizia	liberty and justice
extracomunitarie	outside the community
presidente della regione	President of the region
agenda digitale	Digital Agenda
confederazione europea dei sindacati	European Trade Union Confederation
legislatori	legislators
legislatore	legislator
fondo europeo	European Fund
matteo renzi	Matteo renzi
politica sociale	social policy
terrorismo	terrorism
donne nella politica	women in politics
donne in politica	women in politics
no tav	No tav
manifestazione	event
protocollo kyoto	kyoto protocol
manifestazioni	events
leader di partito	party leaders
le pen	Le pen
pietro grasso	Pietro grasso
profughi	refugees
pil	GDP
profughe	refugee women
spread	spread
parlamentare europea	European parliamentary
trasporti	transport
patto di stabilità	Stability Pact
alfano	Alfano
viceministra	viceministra
corte internazionale di giustizia	International Court of Justice
cristiano-democratici e conservatori	Christian Democrats and conservatives
soffitto di cristallo	Crystal ceiling light
voti	ratings
euroscettici	Eurosceptics
sindacati	unions
parità di genere	gender equality
euroscettico	Euro-sceptic
partito democratico europeo	European democratic party
sindacato	Union
austerity	austerity
open data	Open data
controllo del territorio	territorial control
beppe grillo	Beppe grillo
bilancio comunitario	Community budget
voto	rating
giustizia	Justice
ppe	PPE
la destra	the right
sanzione	sanction
usb	USB
sanzioni	sanctions
sit-in	sit-in
mandato di cattura	bench warrant
catherine margaret ashton	Catherine margaret ashton
palazzo chigi	Palazzo chigi
euroscetticismo	Euroscepticism
euroscetticismi	euroscetticismi
vicesegretaria	Deputy Secretary
vicesegretarie	vicesegretarie
redditi minimi	minimum incomes
movimento lavoratori	workers ' movement
vicesegretario	Deputy Secretary
imprenditori	entrepreneurs
austerità	austerity
imprenditore	Entrepreneur
emergency	emergency
clandestino	stowaway
alexis tsipras	Alexis tsipras
pse	PSE
direttive	directives
comunitari	Community
clandestini	illegals
consiglio europeo	European Council
clandestine	clandestine
presidente della camera	Speaker of the House
germania	Germany
draghi	Dragons
clandestina	illegal
migrante irregolare	irregular migrant
insegnante	teacher
laura boldrini	Laura boldrini
carcerarie	prison
catherine ashton	Catherine ashton
consiglio superiore della magistratura	the Superior Council of Magistracy
politiche sanitarie	health policies
carceraria	prisons
direttiva	Directive
regno unito	United Kingdom
salute	Bless you
extracomunitari	non-EU citizens
van rompuy	Van rompuy
imprenditoriale	entrepreneurial
salario	salary
invasione	invasion
carcerario	prisons
presidente del senato	President of the Senate
elezione	election
elezioni	election
nuovo centrodestra	Mashreq
imprenditoriali	entrepreneurial skills
europarlamentari	MEPs
debito pubblico	public debt
josé manuel durão barroso	José manuel durão barroso
redditi di cittadinanza	income of citizenship
cav	CAV
giudiziari	judicial
mobilità	mobility
europarlamentare	MEP
sicurezza alimentare	food safety
trattato	Treaty
movimenti	movements
petizioni	Petitions
insegnanti	teachers
camera	room
unione politica	political Union
movimento	movement
trattati	treated
presidente del parlamento europeo	President of the European Parliament
lampedusa	Lampedusa
pubblica amministrazione	public administration
volantinaggio	leafleting
viceministro	Deputy Minister
disoccupato	unemployed
csm	CSM
petizione	petition
docenti	teachers
viceministri	Deputy Ministers
movimento 5 stelle	movement 5 stars
docente	Professor
viceministre	viceministre
politica di e-government	e-government policy
corte di giustizia europea	the European Court of Justice
truffolo	truffolo
centri di identificazione ed espulsione	identification and expulsion centres
anti trust	anti trust
disoccupati	unemployed
diritti umani	human rights
disoccupata	unemployed
garante concorrenza mercato	sponsor competition market
disoccupate	unemployed
garante comunicazioni	communications supervisor
mediatore europeo	European Ombudsman
frontiera	frontier
destra radicale	radical right
sindacalisti	trade unionists
laicità	secularism
regolamento	Regulation
costituzione	Constitution
parlamento	Parliament
sindacalista	trade unionist
frontiere	borders
sindacaliste	Union members
sindacati di base	the basic trade unions
comitato delle regioni	Committee of the regions
prestazioni sanitarie	health benefits
cultura	culture
comizio	Rally
guy verhofstadt	Guy verhofstadt
culture	cultures
corridoio europeo	European corridor
matteo salvini	Matteo salvini
unione europea	European Union
pareggio di bilancio	balanced budgets
ces	CES
guerra	war
redistribuzioni	redistribution
angela dorothea merkel	Angela dorothea merkel
guerre	wars
regolamenti	regulations
amnesty italia	Amnesty italia
redistribuzione	redistribution
populismo	populism
precaria	precarious
kompatscher	kompatscher
precarie	precarious
partito della sinistra europea	Party of the European left
vendola	Vendola
asilo politico	political asylum
certezza della pena	certainty of punishment
precario	temp
sicurezza	safety
scuola	school
rapporto deficit pil	deficit GDP ratio
uil	you *
traffico	traffic
governance ue	EU governance
scontro	clash
capo dello stato	Head of State
napolitano	Napolitano
bilancio	budget
università	University
samaras	Samaras
eurogruppo	Eurogroup
scontri	clashes
cie	CIE
partito socialista europeo	the party of European Socialists
poteri forti	vested interests
scuole	schools
media	Media
vicesegretari	Deputy Secretaries
quote latte	milk quotas
euroscettica	Eurosceptic
socialisti e democratici	Socialists and Democrats
turismo	Tourism
integrazione	integration
consiglio d'europa	the Council of Europe
donne e la politica	women and politics
franziska maria keller	Franziska maria keller
infrastruttura	infrastructure
potere forte	strong power
infrastrutture	infrastructure
merkel	Merkel
precariati	reservoirs
eurocrate	Eurocrat
sottosegretario	Undersecretary
precariato	job insecurity
partito popolare europeo	the European people's Party
eurocrati	Eurocrats
alde	ALDE
studente	student
studenti	students
mario mauro	Mario mauro
pubblico	audience
sottosegretarie	sottosegretarie
sottosegretaria	Under Secretary
immigrazione	Immigration
conferenza stampa	Press Conference
mercati	markets
operaia	worker
reato	crime
sindaco	Mayor
herman achille van rompuy	Herman achille van rompuy
operaie	workers
arci	ARCI
tetto al 3%	roof at 3%
trattato di schengen	schengen Treaty
erasmus	Erasmus
reati	offences
ogm	GMO
hollande	hollande
europeiste	pro-European
operaio	workman
europeista	Europeanist
udc	UDC
fi	fi
studentesse	schoolgirls
tavola della pace	table of peace
regionalisti	regionalists
studentessa	student
femminicidi	feminicides
mercato	market
unione di centro	Unione di centro
parlamentari europei	European parliamentarians
europa democratica	democratic Europe
parlamentari europee	European parliamentarians
impresa	Enterprise
garante privacy	privacy guarantor
povertà	poverty
eudebate2014	eudebate2014
programma elettorale	election program
coldiretti	coldiretti
magistratura	judiciary
imprese	enterprises
politica	politics
occupazione	employment
mercato unico	single market
sbarchi	landings
volantinaggi	leaflets
politica educativa	educational policy
disuguaglianze	inequalities
alleanza della sinistra verde nordica	Nordic Green Left Alliance
monopoli	Monopoli
disuguaglianza	inequality
governatrice	Governor
ius sanguinis	jus sanguinis
euroregione	Euroregion
fortezza europa	Fortress Europe
legambiente	legambiente
assistenze	assists
irregolari	irregular
assistenza	assistance
movimento forconi	movement pitchforks
casini	Casini
tassa	fee
eu	EU
blocchi	blocks
energia alternativa	alternative energy
tassi	rates
europeisti	pro-Europeans
david cameron	David cameron
governatrici	governatrici
tasse	taxes
legittimità	legitimacy
società civile	civil society
jean-claude juncker	Jean-claude juncker
soldato	soldier
antitrust	Antitrust
razzismo	racism
soldati	soldiers
grasso	fat
quota rosa	Pink quota
montecitorio	Montecitorio
tasso	rate
eudebate14	eudebate14
contadino	farmer
immigrato	immigrant
scelta europea	European choice
establishment	establishment
gruppo europeo di interesse economico	European economic interest grouping
scelta civica	civic choice
immigrata	immigrant
contadina	peasant woman
immigrate	immigrant women
immigrati	immigrants
contadini	peasants
contadine	peasant women
angela merkel	Angela merkel
il caimano	the Caiman
parlamento europeo	the European Parliament
authority anti-trust	anti-trust authority
criminali	criminals
b.	b.
sottosegretari	Secretaries
presidente del consiglio regionale	President of the Regional Council
criminale	Criminal
carcerari	prisons
primo ministro	Prime Minister
traffico aereo	air traffic
imprenditoria	entrepreneurship
deficit democratico	democratic deficit
rapporto deficitpil	report deficitpil
banca centrale europea	the European Central Bank
garante energia gas	gas energy supervisor
donald franciszek tusk	Donald franciszek tusk
esecutivo	Executive
tetto del 3%	the roof of the 3%
esecutivi	Executive Directors
sindaci	mayors
notav	notav
sel	SEL
barroso	Barroso
carcerate	inmates
energie alternative	alternative energies
tetto del 3 percento	the roof of the 3%
carcerata	convict
berlu	berlu
palazzo madama	Palazzo madama
carcerati	inmates
legislature	legislatures
quote rosa	gender quotas
programmi elettorali	election programmes
ticket	ticket
avaaz italia	Avaaz Canada
tetto di cristallo	glass ceiling
wilders	Wilders
malvivente	Gangster
agenda sociale	social agenda
malviventi	gangsters
welfare	welfare
servizi pubblici	public services
campagna elettorale	election campaign
disoccupazione	unemployment
fondi strutturali	structural funds
gas	gas
bilancio ue	EU budget
pd	PD
legislatura	term
ius soli	ius soli
angelino alfano	Angelino alfano
organismi geneticamente modificati	genetically modified organisms
carcerato	inmate
monti	Monti
antonis samaras	Antonis samaras
john reinfeldt	John reinfeldt
mauro	Mauro
governo	Government
governi	Governments
casta	caste
sindacali	trade unions
fisco	IRS
sindacale	Union suit
rapporto deficit-pil	deficit-GDP ratio
igp	PGI
sinistra radicale	radical left
privatizzazione	privatization
elezione europea	European election
privatizzazioni	privatization
costituzione europea	European Constitution
wwf italia	WWF italia
blocco	block
banca	Bank
greenpeace italia	Greenpeace Italy
esercito	Army
eserciti	armies
giorgia meloni	Giorgia meloni
esercito militare	military army
pier ferdinando casini	Pier ferdinando casini
sussidio di disoccupazione	Dole
italia	Italy
commercio internazionale	international trade
segretario	Secretary
salariato	wage earner
salariati	wage earners
mario draghi	Mario draghi
tetto 3%	roof 3%
mariano rajoy	Mariano rajoy
tecnocrazia	technocracy
energia pulita	clean energy
parti sociali	social partners
authority energia gas	gas energy authority
criminalità	crime
politica estera	foreign policy
pirateria informatica	hacking
boldrini	Boldrini
maastricht	Maastricht
detenzione	detention
politica estera e difesa	Foreign Affairs and defense
soldatessa	soldier
soldatesse	female soldiers
corridoio 5	Corridor 5
votazione	vote
visco	Visco
votazioni	votes
accoglienza	hospitality
governatore	Governor
governatori	Governors
segretarie	Secretaries
licenziamento	dismissal
segretaria	Secretary
carte dei diritti	charters of rights
licenziamenti	layoffs
crimea	Crimea
immigrato irregolare	undocumented migrant
authority privacy	authority policy
slow food	slow food
martin schultz	Martin schultz
dop	DOP
articolo 21	Article 21
presidente di regione	region President
reddito di cittadinanza	basic income
keller	Keller
f35	F35
astensione	abstention
rompuy	rompuy
astensioni	abstentions
politica sanitaria	health policy
corte costituzionale	Constitutional Court
stipendi	salaries
tetto 3 percento	roof 3%
herman rompuy	Herman rompuy
omofobia	homophobia
donna	female
donne e politica	women and politics
stipendio	salary
alleanza europea per la libertà	European Alliance for freedom
regolamentazioni	regulations
segretari	Secretaries
regolamentazione	Regulation
ristrutturazioni aziendali	company restructuring
quirinale	Quirinale
donne	women
lucke	Lucke
pari opportunità	equal opportunities
crescita	growth
commissione europea	European Commission
elezioni europee	European elections
fondo strutturale	Structural Fund
josé barroso	José barroso
donald tusk	Donald tusk
arno kompatscher	Arno kompatscher
sostenibilità	sustainability
ue	EU
crisi economica	economic crisis
nativa digitale	Digital native
indicazione geografica protetta	protected geographical indication
cgil	CGIL
professore	Professor
asili	kindergartens
finanziamento	financing
asilo	kindergarten
professori	professors
finanziamenti	funding
bilancio europeo	European budget
banche	banks
capo del governo	Head of Government
deputata	Congresswoman
cavaliere	Knight
deputate	women deputies
job act	jobs act
deputati	Deputies
silvio berlusconi	Silvio berlusconi
deputato	Congressman
gianluca iannone	Alexis Ibarra
ricerca	Search
ambiente	environment
salariale	salary cap
tsipras	tsipras
dazi doganali	Customs duties
tetto al 3 percento	roof at 3%
europa sociale	social Europe
istruzione	user's Guide
immigrate irregolari	undocumented immigrant
politica economica	economic policy
energie rinnovabili	renewable energies
partito democratico	Democratic Party
josé manuel barroso	José manuel barroso
volontari	Volunteers
unione dei sindacati di base	Union of trade unions of base
ristrutturazione aziendale	corporate restructuring
tusk	Tusk
dibattiti	debates
evasione fiscale	tax evasion
profugo	refugee
alleanza dei conservatori e riformisti europei	Alliance of European conservatives and reformists
mariano rajoy brey	Mariano rajoy brey
tetto tre percento	roof three percent
libro verde	Green Paper
servizio pubblico	public service
sindacato di base	Basic Trade Union
josé bové	José bové
senato	Senate
profuga	Fugee
dibattito	debate
pierferdi	William
divario retributivo	wage gap
agricoltura	Agriculture
confindustria	Confindustria
fiore	flower
europarlamento	European Parliament
partito verde europeo	European Green Party
candidato commissione eu	eu Commission candidate
energia rinnovabile	renewable energy
nigel paul farage	Nigel paul farage
anti-trust	anti-trust
effetto serra	greenhouse effect
debiti pubblici	public debts
garante anti-trust	guarantor anti-trust
comunicazioni	communications
banchieri	bankers
europa dei diritti	Europe of rights
banchiere	Banker
referendum	referendum
parte sociale	social part
senatrici	Senators
authority concorrenza mercato	market competition authority
senatrice	Senator
privato	private
authority comunicazioni	authority communications
sbarco	landing
fmi	IMF
legislazioni	laws
cittadinanza	citizenship
meloni	melons
legislazione	legislation
impresari	contractors
operai	workers
traffico navale	ship traffic
iannone	Iannone
semestre europeo	the European semester
cisl	CISL
arcigay	arcigay
salvini	Salvini
quota latte	milk quota
politica del lavoro	labour policy
telleurope	telleurope
ricerche	Research
cambiamento climatico	climate change
prestazione sanitaria	healthcare service
arresto	arrest
divario digitale	digital divide
pace	peace
fiom	fiom
bambine	teenagers
rifugiata	refugee
bambina	little girl
rifugiate	refugee women
organismo geneticamente modificato	genetically modified organism
concorrenza	competition
rifugiati	refugees
delinquente	thug
arresti	arrests
delinquenti	Crooks
rifugiato	refugee
forza nuova	new force
bambino	baby
rivolta	revolt
bambini	Kids
accesso ai dati pubblici	access to public data
libro bianco	white paper
ska keller	Ska keller
pensioni	pensions
pesc	CFSP
pensione	pension
cortei	parades
sinistra ecologia libertà	left ecology freedom
movimento cinque stelle	Movimento cinque stelle
berlusconi	Berlusconi
energie pulite	clean energy
inflazione	inflation
corteo	procession
respingimenti	rejections
francesco storace	Francesco storace
lega nord	Lega nord
respingimento	refusal of entry
ep2014	ep2014
farmacie	pharmacies
farmacia	Pharmacy
presidente della repubblica	President of the Republic
corte dei conti europea	European Court of Auditors
mario monti	Mario monti
grillo	Cricket
neoliberismo	neoliberalism
premier	Premier
interviste	interviews
intervista	interview
sabine-ita.owl#tetto del 3%25	sabine-ita.owl # 3% 25 roof
acqua	water
comitato militare dell'unione europea	European Union military Committee
sabine-ita.owl#tetto al 3%25	sabine-ita.owl # 3% ceiling 25
banca d'italia	Bank of Italy
movimento politico cristiano d'europa	European Christian political movement
sit	sit
istituzione	institution
corte europea dei diritti dell'uomo	the European Court of human rights
fiducia nell'istituzione	confidence in the institution
uomo	male
alleanza dei liberali e democratici per l'europa	Alliance of Liberals and Democrats for Europe
sabine-ita.owl#tetto 3%25	sabine-ita.owl # 3% 25 roof
donne politica	women in politics
presidente del consiglio d'europa	President of the Council of Europe
fratelli d'italia	Brothers of Italy
popolari per l'italia	popular for Italy
forum italiano dei movimenti per l'acqua	Italian Forum of water movements
